-------TTTTT-----C--
-----TTTTTTTTT------
---TTTTTTTTTTTTT----
--TTTTTTTTTTTTTTT---
--TZG---------GZT---
--TO------------T---
--TO--------L---T---
--T---------L---T---
--T------W------T---
--T------W------T---
--T-------------T---
--T--MM-----MM--T---
--T------J------T---
--T---------A---T---
--T----A--------T---
--T------JJ-----T---
--TTTTTTTTTTTTTTT---
---TTTTTTTTTTTTT----
-----TTTTTTTTT------
-------TTTTT--------